26 26
21111111111111111111111112
10000000000000000000000001
100000s0000000000000000001
10000000000000000000000001
10000000000000000000000001
10000000000001111111111111
10000000000000000000000001
10000000000000000000000001
10000000000000000000000001
10001111111111111111110001
10000000000001000000000001
10000000000001000000000001
10000000000001000000000001
10000000000001000000000001
10000000000001000000000001
10000000000001000000000001
10000000000001000000000001
10000000000001000000000001
10000000000000000000000001
10000000000000000000000001
10000000000000000000000001
11111111111110000000000001
10000000000000000000000001
10000000000000000000000001
10000000000000000000000001
21111111111111111111111112