21 42
211111111111111111112111111111111111111112
100000000000000000001000000000000000000001
100000000000000000001000000000000000000001
100000000000000000001000000000000000000001
100000000000000000001000000000000000000001
100000000000000000001000000000000000000001
100000000000000000001000000000000000000001
100000000000000000001000000000100000000001
100000100000000000000000000000100000000001
100000100000000000000000000000100000000001
100000100000000000000000000111111110000001
100000111111000000000000000000010000000001
100000000000000000000000000000010000000001
100000000000000000000000000000010000000001
100000000000000000001000000000000000000001
100000000000000000001000000000000000000001
100000000000000000001000000000000000000001
100000000000000000001000000000000000000001
100000000000000000001000000000000000000001
100000000000000000001000000000000000000001
211111111111111111112111111111111111111112