26 26
21111111111111111111111112
10000000000000000000000001
100000s0000000000000000001
10000000000000000000000001
10001000000111100000010001
10001000000122100000010001
10001000000122100000010001
10001000000122100000010001
10001000000122100000010001
10001000000122100000010001
10001000000122100000010001
10001000000122100000010001
10001000000122100000010001
10001111111222211111110001
10001000000122100000010001
10001000000122100000010001
10001000000122100000010001
10001000000122100000010001
10001000000122100000010001
10001000000122100000010001
10001000000122100000010001
10001000000111100000010001
10000000000000000000000001
10000000000000000000000001
10000000000000000000000001
21111111111111111111111112