21 21
211111111121111111112
100000000010000000001
100000000010000000001
100000s00010000000001
100000000010000000001
100000000010000000001
100000000010000000001
100000000010000000001
100000000000000000001
100000000000000000001
211111110000011111112
100000000000000000001
100000000000000000001
100000000010000000001
100000000010000000001
100000000010000000001
100000000010000000001
100000000010000000001
100000000010000000001
100000000010000000001
211111111111111111112