21 21
211111111111111111112
100000000000000000001
1000000s0000000000001
100000000000000000001
100000000000111110001
100000000000000010001
100000000000000010001
100000000000000010001
100010000000000010001
100010000000000010001
100010000000000010001
100011111100000010001
100000000000000010001
100000000000000010001
100000000000000010001
100000000000000010001
100000000011111110001
100000000000000000001
100000000000000000001
100000000000000000001
211111111111111111112